############################################################
#..........................................................#
#..........................................................#
#..........................................................#
#....##############%%%%%%############.......................
#....#..............................#.......................
#....#..............................#.......................
######...................#####......#........   ............
#.............        .......#......#......       ..........
#.............        .......#......#........   ............
#............................#......#......................#
###################..........#......#......................#
#.................#..........#......#......................#
#.................#..........########......................#
#.................#..............#.............@.......#####
#.................#..............#.....................#...#
#.................#..............#....................##...#
#.......#######...#..............%....................#....#
#.......#.....#...#######........%...................##....#
#.......#...#.#.........#........#...................#.....#
#.......#...#.#.........#........#...................#.....#
#.......#...###.........#........############x########.....#
#.......#...............#.............#....................#
#.......#################.............#....................#
#...................#.................#....................#
#...................#.................#....................#
#...................%........##########....................#
#...................#........#.............................#
#...................#........#.............................#
############################################################
