.#..........................................................
.#..........................................................
.#.......###############################################....
.#    ...#.............................................#....
.#...............######%%%%%#############..............#....
.#.......%.......#................#.....#..  ..........#....
.#.......%.......#.################.....#...   ........#....
.#....   %.......#.#..............#.....#.....   ......#....
.#....   %.......#.#.############.#...###.......   ....#....
.#....   #.......#.#.#..........#.#.....#.......   ....#....
.#....  .#.......#.#.#.########.#.####..#......   .....#....
.#....  .#.......#.#.#.#......#.#.#.....x.....   ......#....
.#.......#.......#.#.#.#.####.#.#.#..####....   .......#....
.#     ..#.......#.#.#.#.#@.#.#.#.#.....#...   ........#....
.#.......#.......#.#.#.#.##.#.#.#.####..#..   .........#....
.#....   #.......#.#.#.#....#.#.#.#.....#.   .......   #....
.#.......#.......#.#.#.######.#.#.#...###   .......   .#....
.#.......#.......#.#.#........#.#.#.....#  .......   ..#....
.#.......#.......#.#.##########.#.####..# .......   ...#....
.#   ....#.......#.#............#.#.....#.......   ....#....
.#.......#.......#.##############.###...#......   .....#....
.#...    #.......#................#.....%.....   ......#....
.#.......#.......##################.....%....   .......#....
.#.......#.......#......................#...   ........#....
.#    ...###....#########################..   .........#....
.#.........#....##################.........  ..........#....
.#.........#...........................................#....
.#######################################################....
............................................................
............................................................
