                                                            
                                      ##################### 
                                     ##...................# 
                        #x####      ##...########...####### 
                       #....###    ##...##  ####...##       
                       #......#   ##...##  ##.....##        
   #############       #......#   #..###  ##....###         
   #...........####    #......#   #..#    #..####           
   #...@..........#    ##....##   #..#  ###..############   
   #..............#     #....#    #..#  %...............#   
   ##############.#     #...##   ##..#  %...............#   
                #.###   #...## ##...## #########..######    
                #...##  ###..####...#           #.#         
                ##...##   ##...#...##           #.#         
                 ##...##   ##.....##            #.#         
                  ##...##   #######             #.#         
        ###########....##                       #.#         
        #...............####                    #.#         
         ..................###                  #.##        
         ....................###                #..#        
        ###################...##                #..#        
                          ##...##          ######%%##       
                           ##...###        #........#       
                            ###...###      #........#       
                              ###...###    #........#       
                                ###...######........#       
                                  ###...............#       
                                    ####............#       
                                       ##############       
                                                            
