############################################################
#............................#.............................#
#............................#.............................#
#...         ................#.............................#
#...       ..................#....##################.......#
#...      ...................#....#........................#
#...      ....##########.....#....#........................#
#.............#........#.....#....#........................#
#....#........#..@.....#.....#....#####%%%##################
#....#........#######..#.....#....#........................#
#....#.................#.....#....#........................#
#....#.................#.....#....#........................#
#....#.................#.....#....#........................#
#....###################.....#....#........................#
#....#.......................#....#........................#
#....#.......................#....#......########%%%##.....#
#....#.......................#....#......#.....#.....#.....#
#....#.......................#....#......#.....#.....#.....#
#....#.......................#....#......#.....#.....#.....#
#....#....####################....#......#.....x.....#.....#
#....#....#.......................#......#.....#.....#.....#
#....#....#.......................#......#.....#######.....#
#....#....#.......................#......#.....#...........#
#....#....#.......................#......#.....#...........#
#....#....#########%%%%%%%%%#######......#.....#...........#
#....#............................#......#.....#...........#
#....#............................#............#...........#
#....#............................#............#...........#
#....#.........................................#...........#
############################################################
