############################################################
#..........................................................#
#..........................................................#
#..........................................................#
#....##############%%%%%%############......................#
#.@..#..............................#......................#
#....#..............................#......................#
######........        ...#####......#........   ...........#
#............................#......#......       .........#
#.............        .......#......#........   ...........#
#............................#......#......................#
###################..........#......#......................#
#.................#..........#......#......................#
#.................#..........########......................#
#.................#..............#.....................#####
#.................#..............#.....................#...#
#.................#..............#....................##...#
#.......#######...#..............%....................#....#
#.......#.....#...#######........%...................##....#
#.......#...#.#.........#........#...................#.....#
#.......#...#.#.........#........#...................#.....#
#.......#...###.........#........############x########.....#
#.......#...............#.............#....................#
#.......#################.............#....................#
#...................#.................#....................#
#...................#.................#....................#
#...................%........##########....................#
#...................#........#.............................#
#...................#........#.............................#
############################################################
