############################################################
#..........................................................#
#..........................................................#
#..........................................................#
#....##############%%%%%%############......................#
#....#..............................#......................#
#....#..............................#......................#
######...................#####......#........   ...........#
#.............        .......#......#......       .........#
#.............        .......#......#........   ...........#
#............................#......#......................#
###################..........#......#......................#
#.................#..........#......#......................#
#.................#..........########......................#
#.................#..............#............. .......#####
#.................#..............#.....................#...#
#.................#..............#....................##...#
#.......#######...#..............%....................#....#
#.......#.....#...#######........%...................##....#
#.......#...#.#.........#........#...................#.....#
#.......#...#.#.........#........#...................#.....#
#.......#...###.........#........############x########.....#
#.......#...............#.............#....................#
#.......#################.............#....................#
#...................#.................#....................#
#...................#.................#....................#
#...................%........##########....................#
#...................#........#.............................#
#...................#....@...#.............................#
############################################################
