############################################################
#..........................................................#
#..........................................................#
#..........................................................#
#....#############?%%%%%%?###########......................#
#....#..............................#......................#
#....#..............................#......................#
######...................#####......#........   ...........#
#.............        .......#......#......       .........#
#.............        .......#......#........   ...........#
#............................#......#......................#
###################..........#......#......................#
#.................#..........#......#......................#
#.................#..........########......................#
#.................#..............#............. .......#####
#.................#..............?.....................#...#
#.................#..............?....................##...#
#.......#######...#..............%....................#....#
#.......#.....#...#######........%...................##....#
#.......#...#.#.........#........?...................#.....#
#.......#...#.#.........#........#...................#.....#
#.......#...###.........#........############x########.....#
#.......#...............#.............#....................#
#.......#################.............#....................#
#...................#.................#....................#
#...................?.................#....................#
#...................%........##########....................#
#...................?........#.............................#
#...................#....@...#.............................#
############################################################
