############################################################
#..........................................................#
#..........................................................#
#..........................................................#
#....#############?%%%%%%?###########......................#
#.@..#..............................#......................#
#....#..............................#......................#
######........        ...#####......#........   ...........#
#............................#......#......       .........#
#.............        .......#......#........   ...........#
#............................#......#......................#
###################..........#......#......................#
#.................#..........#......#......................#
#.................#..........########......................#
#.................#..............#.....................#####
#.................#..............?.....................#...#
#.................#..............?....................##...#
#.......#######...#..............%....................#....#
#.......#.....#...#######........%...................##....#
#.......#...#.#.........#........?...................#.....#
#.......#...#.#.........#........#...................#.....#
#.......#...###.........#........############x########.....#
#.......#...............#.............#....................#
#.......#################.............#....................#
#...................#.................#....................#
#...................?.................#....................#
#...................%........##########....................#
#...................?........#.............................#
#...................#........#.............................#
############################################################
